16;16;16;16;16;16;16;16;16;16
16;16;15;16;0;1;2;16;16;16
0;1;1;2;16;16;16;16;16;16
16;16;16;16;16;16;15;16;16;16
16;16;16;16;0;1;2;16;16;16
16;16;16;16;16;16;15;16;16;16
16;16;16;16;0;1;2;16;16;16
16;16;16;16;16;16;16;16;16;16
16;16;16;16;16;16;16;16;16;16
16;16;16;16;16;16;16;16;16;16
